										





						1111111111111111111									1111111111111111111
						2																	  2
						3																	  3
						4																	  4
						5		111111111									111111111		  5
						6		6													6		  6
						7		7													7		  7
						8		8													8		  8
						9		9													9		  9
						2		2													2		  2
						3		3													3		  3
						4		4													4		  4
						5		5													5		  5
						6		6													6		  6
						7		7													7		  7
						8		8													8		  8
						9		9													9		  9
																									  